rows 20
cols 20
players 2

m ....................
m .%%%....%%%%..%%%%%.
m .%......%.........%.
m .%...%%%%......A..%.
m ..................%.
m ............%%%...%.
m ..%%%.%.....%%%.....
m ......%.....%%%.....
m ......%.............
m %........%%........%
m %........%%........%
m .............%......
m .....%%%.....%......
m .....%%%.....%.%%%..
m .%...%%%............
m .%..................
m .%..B......%%%%...%.
m .%.........%......%.
m .%%%%%..%%%%....%%%.
m ....................